achimota_rubulavirus_1	Paramyxoviridae,Rubulavirus,Achimota rubulavirus 1
achimota_rubulavirus_2	Paramyxoviridae,Rubulavirus,Achimota rubulavirus 2
adeno-associated_dependoparvovirus_a	Parvoviridae,Dependoparvovirus,Adeno-associated dependoparvovirus A
adeno-associated_dependoparvovirus_b	Parvoviridae,Dependoparvovirus,Adeno-associated dependoparvovirus B
aedes_flavivirus	Flaviviridae,Flavivirus,Aedes flavivirus
african_green_monkey_simian_foamy	Retroviridae,Spumavirus,African green monkey simian foamy virus
aguacate	Phenuiviridae,Phlebovirus,Aguacate virus
aichivirus_a	Picornaviridae,Kobuvirus,Aichivirus A
akabane_orthobunyavirus	Peribunyaviridae,Orthobunyavirus,Akabane orthobunyavirus
alagoas_vesiculovirus	Rhabdoviridae,Vesiculovirus,Alagoas vesiculovirus
alajuela_orthobunyavirus	Peribunyaviridae,Orthobunyavirus,Alajuela orthobunyavirus
allpahuayo_mammarenavirus	Arenaviridae,Mammarenavirus,Allpahuayo mammarenavirus
alphapapillomavirus_4	Papillomaviridae,Alphapapillomavirus,Alphapapillomavirus 4
alphapapillomavirus_7	Papillomaviridae,Alphapapillomavirus,Alphapapillomavirus 7
alphapapillomavirus_9	Papillomaviridae,Alphapapillomavirus,Alphapapillomavirus 9
ambe	Phenuiviridae,Phlebovirus,Ambe virus
andes_orthohantavirus	Hantaviridae,Orthohantavirus,Andes orthohantavirus
anhanga	Phenuiviridae,Phlebovirus,Anhanga virus
anopheles_a_orthobunyavirus	Peribunyaviridae,Orthobunyavirus,Anopheles A orthobunyavirus
anopheles_b_orthobunyavirus	Peribunyaviridae,Orthobunyavirus,Anopheles B orthobunyavirus
apoi	Flaviviridae,Flavivirus,Apoi virus
aravan_lyssavirus	Rhabdoviridae,Lyssavirus,Aravan lyssavirus
argentinian_mammarenavirus	Arenaviridae,Mammarenavirus,Argentinian mammarenavirus
aroa	Flaviviridae,Flavivirus,Aroa virus
arrabida	Phenuiviridae,Phlebovirus,Arrabida virus
arumowot	Phenuiviridae,Phlebovirus,Arumowot virus
asama_orthohantavirus	Hantaviridae,Orthohantavirus,Asama orthohantavirus
australian_bat_lyssavirus	Rhabdoviridae,Lyssavirus,Australian bat lyssavirus
avian_avulavirus_1	Paramyxoviridae,Avulavirus,Avian avulavirus 1
avian_avulavirus_10	Paramyxoviridae,Avulavirus,Avian avulavirus 10
avian_avulavirus_11	Paramyxoviridae,Avulavirus,Avian avulavirus 11
avian_avulavirus_12	Paramyxoviridae,Avulavirus,Avian avulavirus 12
avian_avulavirus_13	Paramyxoviridae,Avulavirus,Avian avulavirus 13
avian_avulavirus_14	Paramyxoviridae,Avulavirus,Avian avulavirus 14
avian_avulavirus_15	Paramyxoviridae,Avulavirus,Avian avulavirus 15
avian_avulavirus_16	Paramyxoviridae,Avulavirus,Avian avulavirus 16
avian_avulavirus_17	Paramyxoviridae,Avulavirus,Avian avulavirus 17
avian_avulavirus_18	Paramyxoviridae,Avulavirus,Avian avulavirus 18
avian_avulavirus_19	Paramyxoviridae,Avulavirus,Avian avulavirus 19
avian_avulavirus_3	Paramyxoviridae,Avulavirus,Avian avulavirus 3
avian_avulavirus_4	Paramyxoviridae,Avulavirus,Avian avulavirus 4
avian_avulavirus_5	Paramyxoviridae,Avulavirus,Avian avulavirus 5
avian_avulavirus_6	Paramyxoviridae,Avulavirus,Avian avulavirus 6
avian_avulavirus_7	Paramyxoviridae,Avulavirus,Avian avulavirus 7
avian_avulavirus_8	Paramyxoviridae,Avulavirus,Avian avulavirus 8
avian_avulavirus_9	Paramyxoviridae,Avulavirus,Avian avulavirus 9
avian_gyrovirus_2	Anelloviridae,Gyrovirus,Avian gyrovirus 2
avian_metapneumovirus	Pneumoviridae,Metapneumovirus,Avian metapneumovirus
bagaza	Flaviviridae,Flavivirus,Bagaza virus
banna	Reoviridae,Seadornavirus,Banna virus
banzi	Flaviviridae,Flavivirus,Banzi virus
barmah_forest	Togaviridae,Alphavirus,Barmah Forest virus
batama_orthobunyavirus	Peribunyaviridae,Orthobunyavirus,Batama orthobunyavirus
bat_hepacivirus	Flaviviridae,Hepacivirus,Bat hepacivirus
bat_mumps_rubulavirus	Paramyxoviridae,Rubulavirus,Bat mumps rubulavirus
bat_sapovirus_tlc58--hk	Caliciviridae,Sapovirus,Bat sapovirus TLC58/HK
bayou_orthohantavirus	Hantaviridae,Orthohantavirus,Bayou orthohantavirus
bear_canyon_mammarenavirus	Arenaviridae,Mammarenavirus,Bear Canyon mammarenavirus
beilong	Paramyxoviridae,,Beilong virus
betapapillomavirus_1	Papillomaviridae,Betapapillomavirus,Betapapillomavirus 1
betapapillomavirus_2	Papillomaviridae,Betapapillomavirus,Betapapillomavirus 2
betapapillomavirus_3	Papillomaviridae,Betapapillomavirus,Betapapillomavirus 3
betapapillomavirus_4	Papillomaviridae,Betapapillomavirus,Betapapillomavirus 4
betapapillomavirus_5	Papillomaviridae,Betapapillomavirus,Betapapillomavirus 5
betapapillomavirus_6	Papillomaviridae,Betapapillomavirus,Betapapillomavirus 6
bhanja	Phenuiviridae,Phlebovirus,Bhanja virus
bimiti_orthobunyavirus	Peribunyaviridae,Orthobunyavirus,Bimiti orthobunyavirus
black_creek_canal_orthohantavirus	Hantaviridae,Orthohantavirus,Black creek canal orthohantavirus
bokeloh_bat_lyssavirus	Rhabdoviridae,Lyssavirus,Bokeloh bat lyssavirus
bouboui	Flaviviridae,Flavivirus,Bouboui virus
bovine_hepacivirus	Flaviviridae,Hepacivirus,Bovine hepacivirus
bovine_respirovirus_3	Paramyxoviridae,Respirovirus,Bovine respirovirus 3
bowe_orthohantavirus	Hantaviridae,Orthohantavirus,Bowe orthohantavirus
brazilian_mammarenavirus	Arenaviridae,Mammarenavirus,Brazilian mammarenavirus
brazoran	Peribunyaviridae,Orthobunyavirus,Brazoran virus
bruges_orthohantavirus	Hantaviridae,Orthohantavirus,Bruges orthohantavirus
bujaru_phlebovirus	Phenuiviridae,Phlebovirus,Bujaru phlebovirus
bundibugyo_ebolavirus	Filoviridae,Ebolavirus,Bundibugyo ebolavirus
bunyamwera_orthobunyavirus	Peribunyaviridae,Orthobunyavirus,Bunyamwera orthobunyavirus
bwamba_orthobunyavirus	Peribunyaviridae,Orthobunyavirus,Bwamba orthobunyavirus
cacipacore	Flaviviridae,Flavivirus,Cacipacore virus
california_encephalitis_orthobunyavirus	Peribunyaviridae,Orthobunyavirus,California encephalitis orthobunyavirus
california_reptarenavirus	Arenaviridae,Reptarenavirus,California reptarenavirus
cali_mammarenavirus	Arenaviridae,Mammarenavirus,Cali mammarenavirus
candiru_phlebovirus	Phenuiviridae,Phlebovirus,Candiru phlebovirus
canine_morbillivirus	Paramyxoviridae,Morbillivirus,Canine morbillivirus
cano_delgadito_orthohantavirus	Hantaviridae,Orthohantavirus,Cano Delgadito orthohantavirus
cao_bang_orthohantavirus	Hantaviridae,Orthohantavirus,Cao Bang orthohantavirus
capim_orthobunyavirus	Peribunyaviridae,Orthobunyavirus,Capim orthobunyavirus
caraparu_orthobunyavirus	Peribunyaviridae,Orthobunyavirus,Caraparu orthobunyavirus
cardiovirus_a	Picornaviridae,Cardiovirus,Cardiovirus A
cardiovirus_b	Picornaviridae,Cardiovirus,Cardiovirus B
catu_orthobunyavirus	Peribunyaviridae,Orthobunyavirus,Catu orthobunyavirus
cedar_henipavirus	Paramyxoviridae,Henipavirus,Cedar henipavirus
cell_fusing_agent	Flaviviridae,Flavivirus,Cell fusing agent virus
cetacean_morbillivirus	Paramyxoviridae,Morbillivirus,Cetacean morbillivirus
chandipura_vesiculovirus	Rhabdoviridae,Vesiculovirus,Chandipura vesiculovirus
chaoyang	Flaviviridae,Flavivirus,Chaoyang virus
chapare_mammarenavirus	Arenaviridae,Mammarenavirus,Chapare mammarenavirus
chicken_anemia	Anelloviridae,Gyrovirus,Chicken anemia virus
chikungunya	Togaviridae,Alphavirus,Chikungunya virus
choclo_orthohantavirus	Hantaviridae,Orthohantavirus,Choclo orthohantavirus
circular_ssdna_virus_hv-cv1	circular ssDNA virus HV-CV1
cocal_vesiculovirus	Rhabdoviridae,Vesiculovirus,Cocal vesiculovirus
colorado_tick_fever	Reoviridae,Coltivirus,Colorado tick fever virus
corriparta	Reoviridae,Orbivirus,Corriparta virus
cosavirus_a	Picornaviridae,Cosavirus,Cosavirus A
cosavirus_b	Picornaviridae,Cosavirus,Cosavirus B
cosavirus_d	Picornaviridae,Cosavirus,Cosavirus D
cosavirus_e	Picornaviridae,Cosavirus,Cosavirus E
cosavirus_f	Picornaviridae,Cosavirus,Cosavirus F
cowpox	Poxviridae,Orthopoxvirus,Cowpox virus
crimean-congo_hemorrhagic_fever_orthonairovirus	Nairoviridae,Orthonairovirus,Crimean-Congo hemorrhagic fever orthonairovirus
culex_flavivirus	Flaviviridae,Flavivirus,Culex flavivirus
cupixi_mammarenavirus	Arenaviridae,Mammarenavirus,Cupixi mammarenavirus
dabieshan_orthohantavirus	Hantaviridae,Orthohantavirus,Dabieshan orthohantavirus
dengue	Flaviviridae,Flavivirus,Dengue virus
dera_ghazi_khan_orthonairovirus	Nairoviridae,Orthonairovirus,Dera Ghazi Khan orthonairovirus
dhori_thogotovirus	Orthomyxoviridae,Thogotovirus,Dhori thogotovirus
dobrava-belgrade_orthohantavirus	Hantaviridae,Orthohantavirus,Dobrava-Belgrade orthohantavirus
donggang	Flaviviridae,Flavivirus,Donggang virus
dugbe_orthonairovirus	Nairoviridae,Orthonairovirus,Dugbe orthonairovirus
duvenhage_lyssavirus	Rhabdoviridae,Lyssavirus,Duvenhage lyssavirus
eastern_equine_encephalitis	Togaviridae,Alphavirus,Eastern equine encephalitis virus
edge_hill	Flaviviridae,Flavivirus,Edge Hill virus
ekpoma_1_tibrovirus	Rhabdoviridae,Tibrovirus,Ekpoma 1 tibrovirus
ekpoma_2_tibrovirus	Rhabdoviridae,Tibrovirus,Ekpoma 2 tibrovirus
el_moro_canyon_orthohantavirus	Hantaviridae,Orthohantavirus,El Moro Canyon orthohantavirus
entebbe_bat	Flaviviridae,Flavivirus,Entebbe bat virus
enterovirus_a	Picornaviridae,Enterovirus,Enterovirus A
enterovirus_b	Picornaviridae,Enterovirus,Enterovirus B
enterovirus_c	Picornaviridae,Enterovirus,Enterovirus C
enterovirus_d	Picornaviridae,Enterovirus,Enterovirus D
enterovirus_e	Picornaviridae,Enterovirus,Enterovirus E
equine_rhinitis_a	Picornaviridae,Aphthovirus,Equine rhinitis A virus
erbovirus_a	Picornaviridae,Erbovirus,Erbovirus A
european_bat_1_lyssavirus	Rhabdoviridae,Lyssavirus,European bat 1 lyssavirus
european_bat_2_lyssavirus	Rhabdoviridae,Lyssavirus,European bat 2 lyssavirus
everglades	Togaviridae,Alphavirus,Everglades virus
eyach	Reoviridae,Coltivirus,Eyach virus
feline_morbillivirus	Paramyxoviridae,Morbillivirus,Feline morbillivirus
flexal_mammarenavirus	Arenaviridae,Mammarenavirus,Flexal mammarenavirus
foot-and-mouth_disease	Picornaviridae,Aphthovirus,Foot-and-mouth disease virus
fugong_orthohantavirus	Hantaviridae,Orthohantavirus,Fugong orthohantavirus
fusong_orthohantavirus	Hantaviridae,Orthohantavirus,Fusong orthohantavirus
gadgets_gully	Flaviviridae,Flavivirus,Gadgets Gully virus
gairo_mammarenavirus	Arenaviridae,Mammarenavirus,Gairo mammarenavirus
gamboa_orthobunyavirus	Peribunyaviridae,Orthobunyavirus,Gamboa orthobunyavirus
gammapapillomavirus_18	Papillomaviridae,Gammapapillomavirus,Gammapapillomavirus 18
gammapapillomavirus_24	Papillomaviridae,Gammapapillomavirus,Gammapapillomavirus 24
gammapapillomavirus_27	Papillomaviridae,Gammapapillomavirus,Gammapapillomavirus 27
gemycircularvirus_hv-gcv1	Genomoviridae,Gemycircularvirus,Gemycircularvirus HV-GcV1
getah	Togaviridae,Alphavirus,Getah virus
giant_panda_anellovirus	Anelloviridae,,Giant panda anellovirus
giessen_reptarenavirus	Arenaviridae,Reptarenavirus,Giessen reptarenavirus
golden_reptarenavirus	Arenaviridae,Reptarenavirus,Golden reptarenavirus
goose_paramyxovirus_sf02	Paramyxoviridae,Avulavirus,Goose paramyxovirus SF02
gorilla_anellovirus	Anelloviridae,,Gorilla anellovirus
great_island	Reoviridae,Orbivirus,Great Island virus
guajara_orthobunyavirus	Peribunyaviridae,Orthobunyavirus,Guajara orthobunyavirus
guama_orthobunyavirus	Peribunyaviridae,Orthobunyavirus,Guama orthobunyavirus
guanarito_mammarenavirus	Arenaviridae,Mammarenavirus,Guanarito mammarenavirus
guaroa_orthobunyavirus	Peribunyaviridae,Orthobunyavirus,Guaroa orthobunyavirus
gyrovirus_4	Anelloviridae,Gyrovirus,Gyrovirus 4
gyrovirus_gyv3	Anelloviridae,Gyrovirus,Gyrovirus GyV3
gyrovirus_gyv7-sf	Anelloviridae,Gyrovirus,Gyrovirus GyV7-SF
gyrovirus_tu243	Anelloviridae,Gyrovirus,Gyrovirus Tu243
gyrovirus_tu789	Anelloviridae,Gyrovirus,Gyrovirus Tu789
hanko	Flaviviridae,Flavivirus,Hanko virus
hantaan_orthohantavirus	Hantaviridae,Orthohantavirus,Hantaan orthohantavirus
hantavirus_z10	Hantaviridae,Orthohantavirus,Hantavirus Z10
hazara_orthonairovirus	Nairoviridae,Orthonairovirus,Hazara orthonairovirus
heartland	Phenuiviridae,Phlebovirus,Heartland virus
hendra_henipavirus	Paramyxoviridae,Henipavirus,Hendra henipavirus
hepacivirus_a	Flaviviridae,Hepacivirus,Hepacivirus A
hepacivirus_b	Flaviviridae,Hepacivirus,Hepacivirus B
hepacivirus_c	Flaviviridae,Hepacivirus,Hepacivirus C
hepacivirus_d	Flaviviridae,Hepacivirus,Hepacivirus D
hepacivirus_f	Flaviviridae,Hepacivirus,Hepacivirus F
hepacivirus_i	Flaviviridae,Hepacivirus,Hepacivirus I
hepacivirus_j	Flaviviridae,Hepacivirus,Hepacivirus J
hepacivirus_k	Flaviviridae,Hepacivirus,Hepacivirus K
hepacivirus_l	Flaviviridae,Hepacivirus,Hepacivirus L
hepacivirus_m	Flaviviridae,Hepacivirus,Hepacivirus M
hepacivirus_n	Flaviviridae,Hepacivirus,Hepacivirus N
hepatitis_b	Hepadnaviridae,Orthohepadnavirus,Hepatitis B virus
hepatitis_delta	Deltavirus,Hepatitis delta virus
hepatovirus_a	Picornaviridae,Hepatovirus,Hepatovirus A
highlands_j	Togaviridae,Alphavirus,Highlands J virus
hughes_orthonairovirus	Nairoviridae,Orthonairovirus,Hughes orthonairovirus
human_alphaherpesvirus_1	Herpesviridae,Simplexvirus,Human alphaherpesvirus 1
human_alphaherpesvirus_2	Herpesviridae,Simplexvirus,Human alphaherpesvirus 2
human_alphaherpesvirus_3	Herpesviridae,Varicellovirus,Human alphaherpesvirus 3
human_associated_circovirus_1	Circoviridae,Circovirus,Human associated circovirus 1
human_associated_cyclovirus_1	Circoviridae,Cyclovirus,Human associated cyclovirus 1
human_associated_cyclovirus_10	Circoviridae,Cyclovirus,Human associated cyclovirus 10
human_associated_cyclovirus_11	Circoviridae,Cyclovirus,Human associated cyclovirus 11
human_associated_cyclovirus_12	Circoviridae,Cyclovirus,Human associated cyclovirus 12
human_associated_cyclovirus_2	Circoviridae,Cyclovirus,Human associated cyclovirus 2
human_associated_cyclovirus_3	Circoviridae,Cyclovirus,Human associated cyclovirus 3
human_associated_cyclovirus_4	Circoviridae,Cyclovirus,Human associated cyclovirus 4
human_associated_cyclovirus_5	Circoviridae,Cyclovirus,Human associated cyclovirus 5
human_associated_cyclovirus_6	Circoviridae,Cyclovirus,Human associated cyclovirus 6
human_associated_cyclovirus_7	Circoviridae,Cyclovirus,Human associated cyclovirus 7
human_associated_cyclovirus_8	Circoviridae,Cyclovirus,Human associated cyclovirus 8
human_associated_cyclovirus_9	Circoviridae,Cyclovirus,Human associated cyclovirus 9
human_associated_gemykibivirus_1	Genomoviridae,Gemykibivirus,Human associated gemykibivirus 1
human_associated_gemykibivirus_2	Genomoviridae,Gemykibivirus,Human associated gemykibivirus 2
human_associated_gemykibivirus_5	Genomoviridae,Gemykibivirus,Human associated gemykibivirus 5
human_associated_gemyvongvirus_1	Genomoviridae,Gemyvongvirus,Human associated gemyvongvirus 1
human_betaherpesvirus_5	Herpesviridae,Cytomegalovirus,Human betaherpesvirus 5
human_betaherpesvirus_6a	Herpesviridae,Roseolovirus,Human betaherpesvirus 6A
human_betaherpesvirus_6b	Herpesviridae,Roseolovirus,Human betaherpesvirus 6B
human_betaherpesvirus_7	Herpesviridae,Roseolovirus,Human betaherpesvirus 7
human_coronavirus_229e	Coronaviridae,Alphacoronavirus,Human coronavirus 229E
human_coronavirus_hku1	Coronaviridae,Betacoronavirus,Human coronavirus HKU1
human_coronavirus_nl63	Coronaviridae,Alphacoronavirus,Human coronavirus NL63
human_endogenous_retrovirus_k	Retroviridae,,Human endogenous retrovirus K
human_fecal_virus_jorvi2	Circoviridae,,Human fecal virus Jorvi2
human_fecal_virus_jorvi3	Circoviridae,,Human fecal virus Jorvi3
human_fecal_virus_jorvi4	Circoviridae,,Human fecal virus Jorvi4
human_gammaherpesvirus_4	Herpesviridae,Lymphocryptovirus,Human gammaherpesvirus 4
human_gammaherpesvirus_8	Herpesviridae,Rhadinovirus,Human gammaherpesvirus 8
human_immunodeficiency_virus_1	Retroviridae,Lentivirus,Human immunodeficiency virus 1
human_immunodeficiency_virus_2	Retroviridae,Lentivirus,Human immunodeficiency virus 2
human_mastadenovirus_a	Adenoviridae,Mastadenovirus,Human mastadenovirus A
human_mastadenovirus_b	Adenoviridae,Mastadenovirus,Human mastadenovirus B
human_mastadenovirus_c	Adenoviridae,Mastadenovirus,Human mastadenovirus C
human_mastadenovirus_d	Adenoviridae,Mastadenovirus,Human mastadenovirus D
human_mastadenovirus_e	Adenoviridae,Mastadenovirus,Human mastadenovirus E
human_mastadenovirus_f	Adenoviridae,Mastadenovirus,Human mastadenovirus F
human_mastadenovirus_g	Adenoviridae,Mastadenovirus,Human mastadenovirus G
human_metapneumovirus	Pneumoviridae,Metapneumovirus,Human metapneumovirus
human_orthopneumovirus	Pneumoviridae,Orthopneumovirus,Human orthopneumovirus
human_papillomavirus	Papillomaviridae,,Human papillomavirus
human_papillomavirus_type_85	Papillomaviridae,,Human papillomavirus type 85
human_picobirnavirus	Picobirnaviridae,Picobirnavirus,Human picobirnavirus
human_polyomavirus_1	Polyomaviridae,Betapolyomavirus,Human polyomavirus 1
human_polyomavirus_2	Polyomaviridae,Betapolyomavirus,Human polyomavirus 2
human_polyomavirus_3	Polyomaviridae,Betapolyomavirus,Human polyomavirus 3
human_polyomavirus_4	Polyomaviridae,Betapolyomavirus,Human polyomavirus 4
human_polyomavirus_5	Polyomaviridae,Alphapolyomavirus,Human polyomavirus 5
human_respirovirus_1	Paramyxoviridae,Respirovirus,Human respirovirus 1
human_respirovirus_3	Paramyxoviridae,Respirovirus,Human respirovirus 3
human_rubulavirus_2	Paramyxoviridae,Rubulavirus,Human rubulavirus 2
human_rubulavirus_4	Paramyxoviridae,Rubulavirus,Human rubulavirus 4
human_smacovirus_1	Smacoviridae,,Human smacovirus 1
ikoma_lyssavirus	Rhabdoviridae,Lyssavirus,Ikoma lyssavirus
ilheus	Flaviviridae,Flavivirus,Ilheus virus
imjin_orthohantavirus	Hantaviridae,Orthohantavirus,Imjin orthohantavirus
indiana_vesiculovirus	Rhabdoviridae,Vesiculovirus,Indiana vesiculovirus
ippy_mammarenavirus	Arenaviridae,Mammarenavirus,Ippy mammarenavirus
irkut_lyssavirus	Rhabdoviridae,Lyssavirus,Irkut lyssavirus
isfahan_vesiculovirus	Rhabdoviridae,Vesiculovirus,Isfahan vesiculovirus
japanese_encephalitis	Flaviviridae,Flavivirus,Japanese encephalitis virus
jeju_orthohantavirus	Hantaviridae,Orthohantavirus,Jeju orthohantavirus
jugra	Flaviviridae,Flavivirus,Jugra virus
j-virus	Paramyxoviridae,,J-virus
kabuto_mountain	Phenuiviridae,Phlebovirus,Kabuto mountain virus
kadam	Flaviviridae,Flavivirus,Kadam virus
kadipiro	Reoviridae,Seadornavirus,Kadipiro virus
kaeng_khoi_orthobunyavirus	Peribunyaviridae,Orthobunyavirus,Kaeng Khoi orthobunyavirus
kairi_orthobunyavirus	Peribunyaviridae,Orthobunyavirus,Kairi orthobunyavirus
kamiti_river	Flaviviridae,Flavivirus,Kamiti River virus
kasokero_orthonairovirus	Nairoviridae,Orthonairovirus,Kasokero orthonairovirus
kedougou	Flaviviridae,Flavivirus,Kedougou virus
kenkeme_orthohantavirus	Hantaviridae,Orthohantavirus,Kenkeme orthohantavirus
keterah_orthonairovirus	Nairoviridae,Orthonairovirus,Keterah orthonairovirus
khabarovsk_orthohantavirus	Hantaviridae,Orthohantavirus,Khabarovsk orthohantavirus
khujand_lyssavirus	Rhabdoviridae,Lyssavirus,Khujand lyssavirus
kokobera	Flaviviridae,Flavivirus,Kokobera virus
koongol_orthobunyavirus	Peribunyaviridae,Orthobunyavirus,Koongol orthobunyavirus
kyasanur_forest_disease	Flaviviridae,Flavivirus,Kyasanur Forest disease virus
lagos_bat_lyssavirus	Rhabdoviridae,Lyssavirus,Lagos bat lyssavirus
laguna_negra_orthohantavirus	Hantaviridae,Orthohantavirus,Laguna Negra orthohantavirus
laibin_orthohantavirus	Hantaviridae,Orthohantavirus,Laibin orthohantavirus
langat	Flaviviridae,Flavivirus,Langat virus
lassa_mammarenavirus	Arenaviridae,Mammarenavirus,Lassa mammarenavirus
latino_mammarenavirus	Arenaviridae,Mammarenavirus,Latino mammarenavirus
lebombo	Reoviridae,Orbivirus,Lebombo virus
le_dantec_ledantevirus	Rhabdoviridae,Ledantevirus,Le Dantec ledantevirus
leopards_hill	Nairoviridae,Orthonairovirus,Leopards Hill virus
liao_ning	Reoviridae,Seadornavirus,Liao ning virus
lleida_bat_lyssavirus	Rhabdoviridae,Lyssavirus,Lleida bat lyssavirus
lloviu_cuevavirus	Filoviridae,Cuevavirus,Lloviu cuevavirus
loei_river_mammarenavirus	Arenaviridae,Mammarenavirus,Loei River mammarenavirus
louping_ill	Flaviviridae,Flavivirus,Louping ill virus
lujo_mammarenavirus	Arenaviridae,Mammarenavirus,Lujo mammarenavirus
luna_mammarenavirus	Arenaviridae,Mammarenavirus,Luna mammarenavirus
lunk_mammarenavirus	Arenaviridae,Mammarenavirus,Lunk mammarenavirus
luxi_orthohantavirus	Hantaviridae,Orthohantavirus,Luxi orthohantavirus
lymphocytic_choriomeningitis_mammarenavirus	Arenaviridae,Mammarenavirus,Lymphocytic choriomeningitis mammarenavirus
lyssavirus_ozernoe	Rhabdoviridae,Lyssavirus,Lyssavirus Ozernoe
macaca_mulatta_polyomavirus_1	Polyomaviridae,Betapolyomavirus,Macaca mulatta polyomavirus 1
macaque_simian_foamy	Retroviridae,Spumavirus,Macaque simian foamy virus
machupo_mammarenavirus	Arenaviridae,Mammarenavirus,Machupo mammarenavirus
madrid_orthobunyavirus	Peribunyaviridae,Orthobunyavirus,Madrid orthobunyavirus
main_drain_orthobunyavirus	Peribunyaviridae,Orthobunyavirus,Main Drain orthobunyavirus
mamastrovirus_1	Astroviridae,Mamastrovirus,Mamastrovirus 1
mamastrovirus_6	Astroviridae,Mamastrovirus,Mamastrovirus 6
mamastrovirus_8	Astroviridae,Mamastrovirus,Mamastrovirus 8
mamastrovirus_9	Astroviridae,Mamastrovirus,Mamastrovirus 9
mammalian_orthoreovirus	Reoviridae,Orthoreovirus,Mammalian orthoreovirus
mammalian_rubulavirus_5	Paramyxoviridae,Rubulavirus,Mammalian rubulavirus 5
manzanilla_orthobunyavirus	Peribunyaviridae,Orthobunyavirus,Manzanilla orthobunyavirus
maporal_orthohantavirus	Hantaviridae,Orthohantavirus,Maporal orthohantavirus
mapuera_rubulavirus	Paramyxoviridae,Rubulavirus,Mapuera rubulavirus
maraba_vesiculovirus	Rhabdoviridae,Vesiculovirus,Maraba vesiculovirus
marburg_marburgvirus	Filoviridae,Marburgvirus,Marburg marburgvirus
marituba_orthobunyavirus	Peribunyaviridae,Orthobunyavirus,Marituba orthobunyavirus
mayaro	Togaviridae,Alphavirus,Mayaro virus
meaban	Flaviviridae,Flavivirus,Meaban virus
measles_morbillivirus	Paramyxoviridae,Morbillivirus,Measles morbillivirus
menangle_rubulavirus	Paramyxoviridae,Rubulavirus,Menangle rubulavirus
mercadeo	Flaviviridae,Flavivirus,Mercadeo virus
middle_east_respiratory_syndrome-related_coronavirus	Coronaviridae,Betacoronavirus,Middle East respiratory syndrome-related coronavirus
mobala_mammarenavirus	Arenaviridae,Mammarenavirus,Mobala mammarenavirus
modoc	Flaviviridae,Flavivirus,Modoc virus
mojiang_henipavirus	Paramyxoviridae,Henipavirus,Mojiang henipavirus
mokola_lyssavirus	Rhabdoviridae,Lyssavirus,Mokola lyssavirus
molluscum_contagiosum	Poxviridae,Molluscipoxvirus,Molluscum contagiosum virus
monkeypox	Poxviridae,Orthopoxvirus,Monkeypox virus
montana_myotis_leukoencephalitis	Flaviviridae,Flavivirus,Montana myotis leukoencephalitis virus
montano_orthohantavirus	Hantaviridae,Orthohantavirus,Montano orthohantavirus
mopeia_lassa_virus_reassortant_29	Arenaviridae,Arenavirus,Mopeia Lassa virus reassortant 29
mopeia_mammarenavirus	Arenaviridae,Mammarenavirus,Mopeia mammarenavirus
morogoro_mammarenavirus	Arenaviridae,Mammarenavirus,Morogoro mammarenavirus
mossman	Paramyxoviridae,,Mossman virus
mosso_das_pedras	Togaviridae,Alphavirus,Mosso das Pedras virus
mucambo	Togaviridae,Alphavirus,Mucambo virus
mumps_rubulavirus	Paramyxoviridae,Rubulavirus,Mumps rubulavirus
mupapillomavirus_1	Papillomaviridae,Mupapillomavirus,Mupapillomavirus 1
murine_respirovirus	Paramyxoviridae,Respirovirus,Murine respirovirus
murray_valley_encephalitis	Flaviviridae,Flavivirus,Murray Valley encephalitis virus
nairobi_sheep_disease_orthonairovirus	Nairoviridae,Orthonairovirus,Nairobi sheep disease orthonairovirus
nariva	Paramyxoviridae,,Nariva virus
ndumu	Togaviridae,Alphavirus,Ndumu virus
nelson_bay_orthoreovirus	Reoviridae,Orthoreovirus,Nelson Bay orthoreovirus
new_jersey_vesiculovirus	Rhabdoviridae,Vesiculovirus,New Jersey vesiculovirus
nipah_henipavirus	Paramyxoviridae,Henipavirus,Nipah henipavirus
norwalk	Caliciviridae,Norovirus,Norwalk virus
norway_rat_hepacivirus_1	Flaviviridae,Hepacivirus,Norway rat hepacivirus 1
norway_rat_hepacivirus_2	Flaviviridae,Hepacivirus,Norway rat hepacivirus 2
nounane	Flaviviridae,Flavivirus,Nounane virus
nova_orthohantavirus	Hantaviridae,Orthohantavirus,Nova orthohantavirus
ntaya	Flaviviridae,Flavivirus,Ntaya virus
nyando_orthobunyavirus	Peribunyaviridae,Orthobunyavirus,Nyando orthobunyavirus
ochlerotatus_caspius_flavivirus	Flaviviridae,Flavivirus,Ochlerotatus caspius flavivirus
oliveros_mammarenavirus	Arenaviridae,Mammarenavirus,Oliveros mammarenavirus
omsk_hemorrhagic_fever	Flaviviridae,Flavivirus,Omsk hemorrhagic fever virus
onyong-nyong	Togaviridae,Alphavirus,Onyong-nyong virus
ordinary_reptarenavirus	Arenaviridae,Reptarenavirus,Ordinary reptarenavirus
orf	Poxviridae,Parapoxvirus,Orf virus
oriboca_orthobunyavirus	Peribunyaviridae,Orthobunyavirus,Oriboca orthobunyavirus
oropouche_orthobunyavirus	Peribunyaviridae,Orthobunyavirus,Oropouche orthobunyavirus
orthohepevirus_a	Hepeviridae,Orthohepevirus,Orthohepevirus A
orthohepevirus_b	Hepeviridae,Orthohepevirus,Orthohepevirus B
orthohepevirus_c	Hepeviridae,Orthohepevirus,Orthohepevirus C
orthohepevirus_d	Hepeviridae,Orthohepevirus,Orthohepevirus D
orungo	Reoviridae,Orbivirus,Orungo virus
palm_creek	Flaviviridae,Flavivirus,Palm Creek virus
paraguayan_mammarenavirus	Arenaviridae,Mammarenavirus,Paraguayan mammarenavirus
paraiso_escondido	Flaviviridae,Flavivirus,Paraiso Escondido virus
parechovirus_a	Picornaviridae,Parechovirus,Parechovirus A
parechovirus_b	Picornaviridae,Parechovirus,Parechovirus B
parramatta_river	Flaviviridae,Flavivirus,Parramatta River virus
patois_orthobunyavirus	Peribunyaviridae,Orthobunyavirus,Patois orthobunyavirus
pegivirus_a	Flaviviridae,Pegivirus,Pegivirus A
pegivirus_c	Flaviviridae,Pegivirus,Pegivirus C
pegivirus_h	Flaviviridae,Pegivirus,Pegivirus H
phnom_penh_bat	Flaviviridae,Flavivirus,Phnom Penh bat virus
phocine_morbillivirus	Paramyxoviridae,Morbillivirus,Phocine morbillivirus
pirital_mammarenavirus	Arenaviridae,Mammarenavirus,Pirital mammarenavirus
piry_vesiculovirus	Rhabdoviridae,Vesiculovirus,Piry vesiculovirus
piscihepevirus_a	Hepeviridae,Piscihepevirus,Piscihepevirus A
pixuna	Togaviridae,Alphavirus,Pixuna virus
porcine_respirovirus_1	Paramyxoviridae,Respirovirus,Porcine respirovirus 1
porcine_rubulavirus	Paramyxoviridae,Rubulavirus,Porcine rubulavirus
powassan	Flaviviridae,Flavivirus,Powassan virus
primate_erythroparvovirus_1	Parvoviridae,Erythroparvovirus,Primate erythroparvovirus 1
primate_t-lymphotropic_virus_1	Retroviridae,Deltaretrovirus,Primate T-lymphotropic virus 1
primate_t-lymphotropic_virus_2	Retroviridae,Deltaretrovirus,Primate T-lymphotropic virus 2
primate_t-lymphotropic_virus_3	Retroviridae,Deltaretrovirus,Primate T-lymphotropic virus 3
prospect_hill_orthohantavirus	Hantaviridae,Orthohantavirus,Prospect Hill orthohantavirus
punta_toro_phlebovirus	Phenuiviridae,Phlebovirus,Punta Toro phlebovirus
puumala_orthohantavirus	Hantaviridae,Orthohantavirus,Puumala orthohantavirus
qalyub_orthonairovirus	Nairoviridae,Orthonairovirus,Qalyub orthonairovirus
quang_binh	Flaviviridae,Flavivirus,Quang Binh virus
quezon_orthohantavirus	Hantaviridae,Orthohantavirus,Quezon orthohantavirus
rabies_lyssavirus	Rhabdoviridae,Lyssavirus,Rabies lyssavirus
razdan	Phenuiviridae,Phlebovirus,Razdan virus
reptilian_ferlavirus	Paramyxoviridae,Ferlavirus,Reptilian ferlavirus
respiratory_syncytial	Pneumoviridae,,Respiratory syncytial virus
reston_ebolavirus	Filoviridae,Ebolavirus,Reston ebolavirus
rhinovirus_a	Picornaviridae,Enterovirus,Rhinovirus A
rhinovirus_b	Picornaviridae,Enterovirus,Rhinovirus B
rhinovirus_c	Picornaviridae,Enterovirus,Rhinovirus C
rift_valley_fever_phlebovirus	Phenuiviridae,Phlebovirus,Rift Valley fever phlebovirus
rinderpest_morbillivirus	Paramyxoviridae,Morbillivirus,Rinderpest morbillivirus
rio_bravo	Flaviviridae,Flavivirus,Rio Bravo virus
rio_negro	Togaviridae,Alphavirus,Rio Negro virus
rockport_orthohantavirus	Hantaviridae,Orthohantavirus,Rockport orthohantavirus
rodent_hepacivirus	Flaviviridae,Hepacivirus,Rodent hepacivirus
rodent_torque_teno_virus_2	Anelloviridae,,Rodent Torque teno virus 2
rosavirus_a	Picornaviridae,Rosavirus,Rosavirus A
ross_river	Togaviridae,Alphavirus,Ross River virus
rotavirus_a	Reoviridae,Rotavirus,Rotavirus A
rotavirus_b	Reoviridae,Rotavirus,Rotavirus B
rotavirus_c	Reoviridae,Rotavirus,Rotavirus C
rotavirus_f	Reoviridae,Rotavirus,Rotavirus F
rotavirus_g	Reoviridae,Rotavirus,Rotavirus G
rotavirus_h	Reoviridae,Rotavirus,Rotavirus H
rotavirus_i	Reoviridae,Rotavirus,Rotavirus I
royal_farm	Flaviviridae,Flavivirus,Royal Farm virus
rubella	Togaviridae,Rubivirus,Rubella virus
ryukyu_mammarenavirus	Arenaviridae,Mammarenavirus,Ryukyu mammarenavirus
saboya	Flaviviridae,Flavivirus,Saboya virus
saint_louis_encephalitis	Flaviviridae,Flavivirus,Saint Louis encephalitis virus
sakhalin_orthonairovirus	Nairoviridae,Orthonairovirus,Sakhalin orthonairovirus
salehabad_phlebovirus	Phenuiviridae,Phlebovirus,Salehabad phlebovirus
salem	Paramyxoviridae,,Salem virus
salivirus_a	Picornaviridae,Salivirus,Salivirus A
salmon_aquaparamyxovirus	Paramyxoviridae,Aquaparamyxovirus,Salmon aquaparamyxovirus
sandfly_fever_naples_phlebovirus	Phenuiviridae,Phlebovirus,Sandfly fever Naples phlebovirus
sandfly_fever_sicilian	Phenuiviridae,Phlebovirus,Sandfly fever Sicilian virus
sangassou_orthohantavirus	Hantaviridae,Orthohantavirus,Sangassou orthohantavirus
sapporo	Caliciviridae,Sapovirus,Sapporo virus
sathuperi_orthobunyavirus	Peribunyaviridae,Orthobunyavirus,Sathuperi orthobunyavirus
saumarez_reef	Flaviviridae,Flavivirus,Saumarez Reef virus
seal_anellovirus_2	Anelloviridae,,Seal anellovirus 2
seal_anellovirus_3	Anelloviridae,,Seal anellovirus 3
seal_anellovirus_tffn--usa--2006	Anelloviridae,,Seal anellovirus TFFN/USA/2006
semliki_forest	Togaviridae,Alphavirus,Semliki Forest virus
seoul_orthohantavirus	Hantaviridae,Orthohantavirus,Seoul orthohantavirus
sepik	Flaviviridae,Flavivirus,Sepik virus
serra_do_navio_mammarenavirus	Arenaviridae,Mammarenavirus,Serra do Navio mammarenavirus
severe_acute_respiratory_syndrome-related_coronavirus	Coronaviridae,Betacoronavirus,Severe acute respiratory syndrome-related coronavirus
sewage_derived_gemygorvirus_1	Genomoviridae,Gemygorvirus,Sewage derived gemygorvirus 1
sfts_phlebovirus	Phenuiviridae,Phlebovirus,SFTS phlebovirus
shamonda_orthobunyavirus	Peribunyaviridae,Orthobunyavirus,Shamonda orthobunyavirus
shimoni_bat_lyssavirus	Rhabdoviridae,Lyssavirus,Shimoni bat lyssavirus
shuni_orthobunyavirus	Peribunyaviridae,Orthobunyavirus,Shuni orthobunyavirus
simbu_orthobunyavirus	Peribunyaviridae,Orthobunyavirus,Simbu orthobunyavirus
simian_foamy	Retroviridae,Spumavirus,Simian foamy virus
simian_immunodeficiency	Retroviridae,Lentivirus,Simian immunodeficiency virus
simian_rubulavirus	Paramyxoviridae,Rubulavirus,Simian rubulavirus
simian_torque_teno_virus_30	Anelloviridae,Alphatorquevirus,Simian torque teno virus 30
simian_torque_teno_virus_31	Anelloviridae,Alphatorquevirus,Simian torque teno virus 31
simian_torque_teno_virus_32	Anelloviridae,Alphatorquevirus,Simian torque teno virus 32
simian_torque_teno_virus_33	Anelloviridae,Alphatorquevirus,Simian torque teno virus 33
simian_torque_teno_virus_34	Anelloviridae,Alphatorquevirus,Simian torque teno virus 34
sindbis	Togaviridae,Alphavirus,Sindbis virus
sin_nombre_orthohantavirus	Hantaviridae,Orthohantavirus,Sin Nombre orthohantavirus
small_anellovirus	Anelloviridae,,Small anellovirus
small_ruminant_morbillivirus	Paramyxoviridae,Morbillivirus,Small ruminant morbillivirus
solwezi_mammarenavirus	Arenaviridae,Mammarenavirus,Solwezi mammarenavirus
sosuga_rubulavirus	Paramyxoviridae,Rubulavirus,Sosuga rubulavirus
souris_mammarenavirus	Arenaviridae,Mammarenavirus,Souris mammarenavirus
spanish_goat_encephalitis	Flaviviridae,Flavivirus,Spanish goat encephalitis virus
spondweni	Flaviviridae,Flavivirus,Spondweni virus
sudan_ebolavirus	Filoviridae,Ebolavirus,Sudan ebolavirus
tacaiuma_orthobunyavirus	Peribunyaviridae,Orthobunyavirus,Tacaiuma orthobunyavirus
tacaribe_mammarenavirus	Arenaviridae,Mammarenavirus,Tacaribe mammarenavirus
tai_forest_ebolavirus	Filoviridae,Ebolavirus,Tai Forest ebolavirus
tailam	Paramyxoviridae,,Tailam virus
tamana_bat	Flaviviridae,Flavivirus,Tamana bat virus
tamiami_mammarenavirus	Arenaviridae,Mammarenavirus,Tamiami mammarenavirus
tanapox	Poxviridae,Yatapoxvirus,Tanapox virus
tapara	Phenuiviridae,Phlebovirus,Tapara virus
tembusu	Flaviviridae,Flavivirus,Tembusu virus
tete_orthobunyavirus	Peribunyaviridae,Orthobunyavirus,Tete orthobunyavirus
thailand_orthohantavirus	Hantaviridae,Orthohantavirus,Thailand orthohantavirus
thiafora_orthonairovirus	Nairoviridae,Orthonairovirus,Thiafora orthonairovirus
tho	Flaviviridae,Flavivirus,T'Ho virus
thogoto_thogotovirus	Orthomyxoviridae,Thogotovirus,Thogoto thogotovirus
thottapalayam_orthohantavirus	Hantaviridae,Orthohantavirus,Thottapalayam orthohantavirus
tick-borne_encephalitis	Flaviviridae,Flavivirus,Tick-borne encephalitis virus
tioman_rubulavirus	Paramyxoviridae,Rubulavirus,Tioman rubulavirus
tofla	Nairoviridae,Orthonairovirus,Tofla virus
tonate	Togaviridae,Alphavirus,Tonate virus
toros	Phenuiviridae,Phlebovirus,Toros virus
torque_teno	Anelloviridae,,Torque teno virus
torque_teno_canis	Anelloviridae,Thetatorquevirus,Torque teno canis virus
torque_teno_douroucouli	Anelloviridae,Zetatorquevirus,Torque teno douroucouli virus
torque_teno_felis	Anelloviridae,Etatorquevirus,Torque teno felis virus
torque_teno_felis_virus_2	Anelloviridae,Etatorquevirus,Torque teno felis virus 2
torque_teno_indri_virus_1	Anelloviridae,,Torque teno indri virus 1
torque_teno_leptonychotes_weddellii_virus-1	Anelloviridae,,Torque teno Leptonychotes weddellii virus-1
torque_teno_leptonychotes_weddellii_virus-2	Anelloviridae,,Torque teno Leptonychotes weddellii virus-2
torque_teno_midi_virus_1	Anelloviridae,Gammatorquevirus,Torque teno midi virus 1
torque_teno_midi_virus_10	Anelloviridae,Gammatorquevirus,Torque teno midi virus 10
torque_teno_midi_virus_11	Anelloviridae,Gammatorquevirus,Torque teno midi virus 11
torque_teno_midi_virus_12	Anelloviridae,Gammatorquevirus,Torque teno midi virus 12
torque_teno_midi_virus_13	Anelloviridae,Gammatorquevirus,Torque teno midi virus 13
torque_teno_midi_virus_14	Anelloviridae,Gammatorquevirus,Torque teno midi virus 14
torque_teno_midi_virus_15	Anelloviridae,Gammatorquevirus,Torque teno midi virus 15
torque_teno_midi_virus_2	Anelloviridae,Gammatorquevirus,Torque teno midi virus 2
torque_teno_midi_virus_3	Anelloviridae,Gammatorquevirus,Torque teno midi virus 3
torque_teno_midi_virus_4	Anelloviridae,Gammatorquevirus,Torque teno midi virus 4
torque_teno_midi_virus_5	Anelloviridae,Gammatorquevirus,Torque teno midi virus 5
torque_teno_midi_virus_6	Anelloviridae,Gammatorquevirus,Torque teno midi virus 6
torque_teno_midi_virus_7	Anelloviridae,Gammatorquevirus,Torque teno midi virus 7
torque_teno_midi_virus_8	Anelloviridae,Gammatorquevirus,Torque teno midi virus 8
torque_teno_midi_virus_9	Anelloviridae,Gammatorquevirus,Torque teno midi virus 9
torque_teno_mini_virus_1	Anelloviridae,Betatorquevirus,Torque teno mini virus 1
torque_teno_mini_virus_10	Anelloviridae,Betatorquevirus,Torque teno mini virus 10
torque_teno_mini_virus_11	Anelloviridae,Betatorquevirus,Torque teno mini virus 11
torque_teno_mini_virus_12	Anelloviridae,Betatorquevirus,Torque teno mini virus 12
torque_teno_mini_virus_18	Anelloviridae,Betatorquevirus,Torque teno mini virus 18
torque_teno_mini_virus_2	Anelloviridae,Betatorquevirus,Torque teno mini virus 2
torque_teno_mini_virus_3	Anelloviridae,Betatorquevirus,Torque teno mini virus 3
torque_teno_mini_virus_4	Anelloviridae,Betatorquevirus,Torque teno mini virus 4
torque_teno_mini_virus_5	Anelloviridae,Betatorquevirus,Torque teno mini virus 5
torque_teno_mini_virus_6	Anelloviridae,Betatorquevirus,Torque teno mini virus 6
torque_teno_mini_virus_7	Anelloviridae,Betatorquevirus,Torque teno mini virus 7
torque_teno_mini_virus_8	Anelloviridae,Betatorquevirus,Torque teno mini virus 8
torque_teno_mini_virus_9	Anelloviridae,Betatorquevirus,Torque teno mini virus 9
torque_teno_mini_virus_ala22	Anelloviridae,Betatorquevirus,Torque teno mini virus ALA22
torque_teno_mini_virus_alh8	Anelloviridae,Betatorquevirus,Torque teno mini virus ALH8
torque_teno_sus_virus_1a	Anelloviridae,Iotatorquevirus,Torque teno sus virus 1a
torque_teno_sus_virus_1b	Anelloviridae,Iotatorquevirus,Torque teno sus virus 1b
torque_teno_sus_virus_k2a	Anelloviridae,Kappatorquevirus,Torque teno sus virus k2a
torque_teno_sus_virus_k2b	Anelloviridae,Kappatorquevirus,Torque teno sus virus k2b
torque_teno_tamarin	Anelloviridae,Epsilontorquevirus,Torque teno tamarin virus
torque_teno_tupaia	Anelloviridae,Deltatorquevirus,Torque teno tupaia virus
torque_teno_virus_1	Anelloviridae,Alphatorquevirus,Torque teno virus 1
torque_teno_virus_10	Anelloviridae,Alphatorquevirus,Torque teno virus 10
torque_teno_virus_11	Anelloviridae,Alphatorquevirus,Torque teno virus 11
torque_teno_virus_12	Anelloviridae,Alphatorquevirus,Torque teno virus 12
torque_teno_virus_13	Anelloviridae,Alphatorquevirus,Torque teno virus 13
torque_teno_virus_14	Anelloviridae,Alphatorquevirus,Torque teno virus 14
torque_teno_virus_15	Anelloviridae,Alphatorquevirus,Torque teno virus 15
torque_teno_virus_16	Anelloviridae,Alphatorquevirus,Torque teno virus 16
torque_teno_virus_19	Anelloviridae,Alphatorquevirus,Torque teno virus 19
torque_teno_virus_2	Anelloviridae,Alphatorquevirus,Torque teno virus 2
torque_teno_virus_20	Anelloviridae,Alphatorquevirus,Torque teno virus 20
torque_teno_virus_21	Anelloviridae,Alphatorquevirus,Torque teno virus 21
torque_teno_virus_23	Anelloviridae,Alphatorquevirus,Torque teno virus 23
torque_teno_virus_24	Anelloviridae,Alphatorquevirus,Torque teno virus 24
torque_teno_virus_25	Anelloviridae,Alphatorquevirus,Torque teno virus 25
torque_teno_virus_26	Anelloviridae,Alphatorquevirus,Torque teno virus 26
torque_teno_virus_27	Anelloviridae,Alphatorquevirus,Torque teno virus 27
torque_teno_virus_28	Anelloviridae,Alphatorquevirus,Torque teno virus 28
torque_teno_virus_29	Anelloviridae,Alphatorquevirus,Torque teno virus 29
torque_teno_virus_3	Anelloviridae,Alphatorquevirus,Torque teno virus 3
torque_teno_virus_4	Anelloviridae,Alphatorquevirus,Torque teno virus 4
torque_teno_virus_5	Anelloviridae,Alphatorquevirus,Torque teno virus 5
torque_teno_virus_6	Anelloviridae,Alphatorquevirus,Torque teno virus 6
torque_teno_virus_7	Anelloviridae,Alphatorquevirus,Torque teno virus 7
torque_teno_virus_8	Anelloviridae,Alphatorquevirus,Torque teno virus 8
torque_teno_virus_9	Anelloviridae,Alphatorquevirus,Torque teno virus 9
torque_teno_zalophus_virus_1	Anelloviridae,Lambdatorquevirus,Torque teno zalophus virus 1
ttv-like_mini	Anelloviridae,Betatorquevirus,TTV-like mini virus
tuhoko_rubulavirus_1	Paramyxoviridae,Rubulavirus,Tuhoko rubulavirus 1
tuhoko_rubulavirus_2	Paramyxoviridae,Rubulavirus,Tuhoko rubulavirus 2
tuhoko_rubulavirus_3	Paramyxoviridae,Rubulavirus,Tuhoko rubulavirus 3
tula_orthohantavirus	Hantaviridae,Orthohantavirus,Tula orthohantavirus
tupaia_paramyxovirus	Paramyxoviridae,,Tupaia paramyxovirus
uganda_s	Flaviviridae,Flavivirus,Uganda S virus
uriurana	Phenuiviridae,Phlebovirus,Uriurana virus
urucuri	Phenuiviridae,Phlebovirus,Urucuri virus
usutu	Flaviviridae,Flavivirus,Usutu virus
uukuniemi_phlebovirus	Phenuiviridae,Phlebovirus,Uukuniemi phlebovirus
vaccinia	Poxviridae,Orthopoxvirus,Vaccinia virus
variola	Poxviridae,Orthopoxvirus,Variola virus
venezuelan_equine_encephalitis	Togaviridae,Alphavirus,Venezuelan equine encephalitis virus
vesicular_exanthema_of_swine	Caliciviridae,Vesivirus,Vesicular exanthema of swine virus
wesselsbron	Flaviviridae,Flavivirus,Wesselsbron virus
west_caucasian_bat_lyssavirus	Rhabdoviridae,Lyssavirus,West Caucasian bat lyssavirus
western_equine_encephalitis	Togaviridae,Alphavirus,Western equine encephalitis virus
west_nile	Flaviviridae,Flavivirus,West Nile virus
whataroa	Togaviridae,Alphavirus,Whataroa virus
whitewater_arroyo_mammarenavirus	Arenaviridae,Mammarenavirus,Whitewater Arroyo mammarenavirus
wyeomyia_orthobunyavirus	Peribunyaviridae,Orthobunyavirus,Wyeomyia orthobunyavirus
yaba_monkey_tumor	Poxviridae,Yatapoxvirus,Yaba monkey tumor virus
yakeshi_orthohantavirus	Hantaviridae,Orthohantavirus,Yakeshi orthohantavirus
yaounde	Flaviviridae,Flavivirus,Yaounde virus
yellow_fever	Flaviviridae,Flavivirus,Yellow fever virus
yogue	Nairoviridae,Orthonairovirus,Yogue virus
yokose	Flaviviridae,Flavivirus,Yokose virus
yug_bogdanovac_vesiculovirus	Rhabdoviridae,Vesiculovirus,Yug Bogdanovac vesiculovirus
zaire_ebolavirus	Filoviridae,Ebolavirus,Zaire ebolavirus
zerdali	Phenuiviridae,Phlebovirus,Zerdali virus
zika	Flaviviridae,Flavivirus,Zika virus
zygosaccharomyces_bailii_virus_z	Amalgaviridae,,Zygosaccharomyces bailii virus Z
